1111111111
@000000001
1111101111
1001100001
1010101101
1010000101
1011010101
1000010111
111101000E
1111111111